##############
#         O  #
#   P  a  O  #
#            #
#       a    #
#            #
##############
